.......................................
................#......................
.........###########...................
..................#....................
.........########.#....................
................#.#....................
................#.#########............
................#......................
................###########............
................#......................
................#......................
................#......................
................#......................
................#......................
................#......................
................#......................
................#......................
................#......................
................#......................
.......................................