########################################
#x..............x#x.x#x#x......x......x#
################.#.#.#.########.########
#x.....x...x.x..x#.#.#.#x......x#x..x#8#
#.#####.###.#.####.#...########.####.#.#
#x.x#.#.#..x#.#....#.#x........x#x..x#.#
###.#x.x###.#xx#.#.#.#.########.####.#.#
#x.x#.###.#.#.#x#x#x.#.#x......x#x..x#.#
###.#x.x#.#.#x.x.x.x##.########.#.##x.x#
#x.x###.#x.x#.#######xx#.x.x.x.x#x.x####
###.#x.x#.###.#x.....x###x#x#x#x.x#x..7#
#1.x###.#.#3#.########x#x######.########
###.#x.x#.#.#x......x.x.x......x.x.....#
#x.x#.###x.x#.######.##########.#.######
###.#x.2###.#.#4....x#xx.x.x#x#.#x....x#
#x.x#.###x#.#.######.##.#.#.#.#.#.####.#
###.#x.x#.#.#x......x#5x#.#.#.#.#x..6#.#
#x#.###.#.#.#.######.##.#.#.#.#.#.####.#
#x.x#x.x#x.x#x#x....x#xx#.#x.x.x#x...#.#
########################################